111111111111111
100000000000001
101100111001101
100100000001001
100100000001001
100100111001001
100000101000001
000000101000000
000000101000000
100000000000001
100100000001001
100110000011001
101000111000101
100000000000001
111111111111111